   11111111111
   100000100011
111100000000001
10000000S000011
10000000000001
10000000000001
10000000000001111
10001111000000001
10000000000001111
111111111000011111
   100000000000001
   111111111111111