   11111111111
   10000010001
11110001111001
10000000S00001
10000000000001
111111111000011111
   100000000000001
   111111111111111