1111111111111111111
1000000000000000001
1000000000000000001
1000000000000000001
1000000000000000001
1000000000000000001
1000000011111111111
100000001
100000001
100000001
100000001
100000S01
100000001
111111111