1111111111111111111
1000000000000000001
1000000000000000001
1000000000000000001
1000000000000000001
1000000000000000001
1000000011111111111
1000000011
1000000001
1000000001
100000S001
1000000001
1111111111