1111111111111111111
1000000000000000001
1000000000000000001
1000000000000000001
1000000000000000001
1000000000000000001
1000000011111111111
10000100111
10000100001
10000000011 
100000S001
1000000001
1111111111